11111111111111111111
1P0000000000000000E1
10111110111111111011
1C0000000000000000C1
10101110111110111011
1C000000000000000001
11111111111111111111
