1111111111111
1P0000000C001
1010111111011
1000100000001
1C00101110101
1000000000E01
1111111111111
