1111111111111111111111111111111
1P00000100000000001000000000001
1111010111110111110111101111101
1000010000010000010000000000001
1011111111011111111011111111101
1000000001010000000010000000001
1111111011010111111110111111101
1C000001000001000001000000000C1
1011111111110111110111111111101
1000000000000000000000000000001
1011110111111111111111111111101
1000010000010000010000010000001
1111011111011111011111011111101
1C000000001000000000001000000C1
1011111111110111111111111111101
1000000000000000000000000000001
1011110111111011111111111111011
1000010000010000010000010000001
1111011111011111011111011111101
1C00000000100000E000001000000C1
1111111111111111111111111111111
