111111111111111111111
1P00000000000000000E1
101011101110111011101
1000000000C0000000001
101110111011101110101
1000C00000000C0000001
101111111011111111101
100000000C00000000001
101011101110111011101
100000000000000000001
101111011111110111101
1C0000000C00000000001
101011101110111011101
100000000000000000001
101111111011111111101
100000000000000000001
101011101110111011101
1000C00000000C0000001
101011101110111011101
111111111111111111111
