1111111111
1P001000E1
1110111011
1C000000C1
1011111101
1C00000001
1111111111
