111111111111111111111111111111111111111111111111111111111111
1P10000000000C0010000010000010000000000C00000000001000001011
101010111111111010111110101010111110111111111111101110101011
10101000000010001010000010101000C010000000001000100000100C11
101111111010101110101111101111111011111111101010111111111011
10000000101C1010001000101000001000100X0X00101010000010000011
11111110111010101011101011101110111111101X101110101110111111
10000010C000101010100010001000001000000010100010100000100011
1110101111111011101011101111111111101110111110101111101C1011
10001C1000000010001000100000C000000010101000001010X010101011
10111010111111101111101010111111111110101C111011101010111011
100010100010000010000010100000101000000010001010001010000011
111011111010101110111111111010101011111111101110111011111011
1000100010101000100000100010101000100000001000001X0010000011
101110101010111011111010101110111110111110101111101111101111
101C00100010100000001010100010E00000100000101000100000100011
101011111111101111111010111010101111101111111010101110111011
101000000000100000001000100000101000100000000010100010001011
101111111110101111101111101111101010111111111110111111101011
10001000100010000010001000100000101000000010001X100010001011
111010101011101111101010111011111011111110101010101010111011
100010100010X01000101000100010000010100010101010001010001011
101010111111111010111111101010111110101010101111111010101111
101X10100000000010100000101010001000101000100000001010100011
101010101111111110101110101111101010101111101110111010111011
101010101000001000101010100010000010100010100010001010001011
101110101011101011101010111010111110111010111011101011111011
101000101000101000001010001000100010100010100010100010000011
101011101110101111111011101111101011101110101110111110111011
10000000100010000000000000C000001000001000000000000000100011
111111111111111111111111111111111111111111111111111111111111
